%%%%%%%%%%%%%%
%           G%
%%%%%%%%%%%  %
%         %  %
%         %  %
%         %  %
%         %  %
%S        %  %
%%%%%%%%%%%%%%