%%%%%%%%%%%
%  G % S  %
%%%%%%%%%%%
